....XXXX
XXX....X
....XX..
XXXXX..X
XX....XX
X..XX.XX
....XX..
X.......